1111111
1001EC1
1P01001
1111111