11111111111111111111111111111
1C000100100000110000000000001
11110000000000000000000000001
100000001010000000000000001C1
100000001C1P00000000000000111
10001111111100000000000001111
1CC11110000000000110000010001
11111000011000000001001001001
1000000000C100000000000000111
100000000000000000000000000C1
11000000000000000000001111111
11110000000000000000000000001
100000001010000000000000001C1
100000000000100100000000000E1
11111111111111111111111111111