1111111111111
100C0000000C1
1000011111111
100000C0000E1
10000100010P1
1111111111111
