1111111
1E000C1
1P00001
1111111