111111
10PEC1
111111
111111
111111
111111
111111
