111111111111111111111111111111111111111111111111111111111111111111111111111
1C00010010000011000000000000C0001001CCCCCCCCCCCCCC00000110000CCCCC000000001
1111000000000000000000000000C0001001CCCCCCCCCCCCCC0000011000000000CCCCC0001
100000001010000000000000001CC0001001CCCCCCCCCCCCCC00000110000CCCCC000000001
100000001C1P0000000000000011C0001001CCCCCCCCCCCCCC00000110000CC00000CCC0001
1000111111110000000000000111C0001001CCCCCCCCCCCCCC00000110CCCCC000000000001
1CC1111000000000011000001000C000100CCCCCCCCCCCCCC10000011000000CCCCC0000001
1111100001100000000100100100C00010010000011000000CCCCCCCCCCCCCC00000CCCCC01
1000000000C10000000000000011C00010010000011CCCCC0000CCCCCCCCCCCCCC000000001
1000000000000CCCCCCCCCCCCCC00000000000000CC0001001000001100000CCCCC00000001
110000000000000000000011111CCCCCCCCCCCCCC100010010000011000000CCCCCC0000001
11110000000000000000000000000001001000CCCCCCCCCCCCCCCCCCC001100000000000001
1000000010100000000001000001001000001100000CCCCC0000000CCCCCCCCCCCCCC0001C1
1000000CCCCCCCCCCCCCC00000100100000010010010000011000000000000CCCCC000000E1
1111000000000000000000000000C0001001CCCCCCCCCCCCCC0000011000000000CCCCC0001
100000001010000000000000001CC0001001CCCCCCCCCCCCCC00000110000CCCCC000000001
100000001C110000000000000011C0001001CCCCCCCCCCCCCC00000110000CC00000CCC0001
1000111111110000000000000111C0001001CCCCCCCCCCCCCC00000110CCCCC000000000001
1CC1111000000000011000001000C000100CCCCCCCCCCCCCC10000011000000CCCCC0000001
1111100001100000000100100100C00010010000011000000CCCCCCCCCCCCCC00000CCCCC01
1000000000C10000000000000011C00010010000011CCCCC0000CCCCCCCCCCCCCC000000001
1000000000000CCCCCCCCCCCCCC00000000000000CC0001001000001100000CCCCC00000001
110000000000000000000011111CCCCCCCCCCCCCC100010010000011000000CCCCCC0000001
11110000000000000000000000000001001000CCCCCCCCCCCCCCCCCCC001100000000000001
1000000010100000000001000001001000001100000CCCCC0000000CCCCCCCCCCCCCC0001C1
1000000CCCCCCCCCCCCCC00000100100000010010010000011000000000000CCCCC000000C1
100000001010000000000000001CC0001001CCCCCCCCCCCCCC00000110000CCCCC000000001
100000001C1C0000000000000011C0001001CCCCCCCCCCCCCC00000110000CC00000CCC0001
1000111111110000000000000111C0001001CCCCCCCCCCCCCC00000110CCCCC000000000001
1CC1111000000000011000001000C000100CCCCCCCCCCCCCC10000011000000CCCCC0000001
1111100001100000000100100100C00010010000011000000CCCCCCCCCCCCCC00000CCCCC01
1000000000C10000000000000011C00010010000011CCCCC0000CCCCCCCCCCCCCC000000001
1000000000000CCCCCCCCCCCCCC00000000000000CC0001001000001100000CCCCC00000001
100000001C100000000000000011C0001001CCCCCCCCCCCCCC00000110000CC00000CCC0001
1000111111110000000000000111C0001001CCCCCCCCCCCCCC00000110CCCCC000000000001
1CC1111000000000011000001000C000100CCCCCCCCCCCCCC10000011000000CCCCC0000001
1111100001100000000100100100C00010010000011000000CCCCCCCCCCCCCC00000CCCCC01
1000000000C10000000000000011C00010010000011CCCCC0000CCCCCCCCCCCCCC000000001
1000000000000CCCCCCCCCCCCCC00000000000000CC0001001000001100000CCCCC00000001
110000000000000000000011111CCCCCCCCCCCCCC100010010000011000000CCCCCC0000001
110000000000000000000011111CCCCCCCCCCCCCC100010010000011000000CCCCCC0000001
111111111111111111111111111111111111111111111111111111111111111111111111111